Laberinto 1
0  0  0  0  0  0  0  0  0  0  0  0  0  0  0  0  0  0  0  0  
0  0  0  2  0  0  1  0  0  0  1  1  1  1  1  1  0  1  0  0  
0  1  1  5  1  1  1  1  1  1  1  1  1  1  1  1  1  1  1  0  
0  0  1  5  0  1  1  0  1  0  0  0  0  1  0  0  1  1  0  0  
0  1  1  5  5  5  1  1  1  1  1  1  1  1  1  1  1  1  1  0  
0  0  0  0  0  5  1  0  0  1  1  0  1  1  1  1  1  1  0  0  
0  1  1  1  1  5  1  1  1  1  1  1  1  1  1  1  1  1  1  0  
0  1  0  1  1  5  0  0  0  1  1  0  0  0  0  1  1  0  1  0  
0  1  1  1  1  5  1  1  1  1  1  1  1  1  1  1  1  1  1  0  
0  1  1  1  1  5  1  0  1  0  1  1  0  0  0  0  0  1  0  0  
0  1  1  1  1  5  5  1  1  1  1  1  1  1  1  1  1  1  1  0  
0  0  0  1  0  1  5  1  0  1  0  0  0  1  0  1  0  0  0  0  
0  1  1  1  1  1  5  1  1  1  1  1  1  1  1  1  1  1  1  0  
0  1  1  0  0  0  5  1  1  0  1  1  1  0  1  1  0  1  1  0  
0  1  1  1  1  1  5  1  1  1  1  1  1  1  1  1  1  1  1  0  
0  0  1  1  1  0  5  0  0  1  0  1  1  1  0  0  0  1  0  0  
0  1  1  1  1  1  5  5  5  5  5  5  1  1  1  1  1  1  1  0  
0  1  0  0  0  0  0  1  1  1  0  5  1  1  0  1  0  0  0  0  
0  1  1  1  1  1  1  1  1  1  1  5  5  5  5  5  5  5  3  0  
0  0  0  0  0  0  0  0  0  0  0  0  0  0  0  0  0  0  0  0  

Laberinto 
ееееееееееееееееееее
еее+ее еее      е ее
е  *               е
ее *е  е ееее ее  ее
е  ***             е
еееее* ее  е      ее
е    *             е
е е  *еее  ееее  е е
е    *             е
е    * е е  еееее ее
е    **            е
еее е * е еее е ееее
е     *            е
е  еее*  е   е  е  е
е     *            е
ее   е*ее е   еее ее
е     ******       е
е еееее   е*  е ееее
е          *******+е
ееееееееееееееееееее
